border_size=1
usage=map

Mm          , Mm          , Mm          , Mm          , Mm          , Mm          , Mm          , Mm          , Mm          , Mm          , Mm          , Mm          , Mm          , Mm          , Mm          , Mm          , Mm          , Mm          , Mm          , Mm          , Mm          , Mm          , Mm          , Mm          , Mm          , Mm          , Mm          , Mm          , Mm          , Hh          , Re          , Rd          , Re          , Re          , Re          , Re          , Rd          , Re          , Re          , Rd          , Rd          , Rd          , Re          , Re          , Rd          , Rd          , Rd          
Mm          , Mm          , Mm          , Mm          , Mm          , Mm          , Mm^Xm       , Mm          , Mm          , Mm          , Mm          , Mm          , Mm^Xm       , Mm          , Mm^Xm       , Mm          , Mm          , Mm          , Mm          , Mm          , Mm          , Mm          , Mm          , Mm          , Mm          , Mm          , Mm          , Mm          , Mm          , Hh          , Re          , Re          , Rd          , Re          , Re          , Rd          , Rd          , Re          , Re          , Re          , Re          , Re          , Re          , Re          , Re          , Re          , Rd          
Mm          , Mm          , Mm          , Mm          , Mm^Xm       , Mm^Xm       , Mm          , Mm^Xm       , Mm          , Mm          , Mm          , Mm^Xm       , Mm          , Mm^Xm       , Mm          , Mm          , Mm          , Mm          , Mm          , Mm          , Mm          , Mm          , Mm          , Mm          , Mm          , Mm          , Mm          , Mm          , Mm          , Hh          , Re          , Rd          , Rd          , Re          , Re          , Re          , Rd          , Rd          , Rd          , Re          , Re          , Re          , Ur          , Ur          , Ur          , Re          , Re          
Mm          , Mm          , Mm^Xm       , Mm^Xm       , Mm^Xm       , Mm          , Hh          , Mm          , Hh          , Mm          , Hh          , Hh          , Mm          , Mm          , Mm          , Mm          , Hh          , Mm          , Mm          , Mm          , Mm          , Mm          , Mm          , Mm          , Mm          , Mm          , Mm          , Mm          , Hh          , Hh          , Re          , Rd          , Re          , Re^Vct      , Re          , Re          , Rd          , Rd          , Re          , Re          , Re          , Ur          , Uu          , Uu          , Uu          , Ur          , Re          
Mm          , Mm          , Mm          , Mm          , Mm^Xm       , Mm          , Hh          , Hh          , Gg          , Hh          , Ggf         , Hh          , Hh          , Hh          , Hh          , Hh          , Gs^Fds      , Hh          , Hh          , Mm          , Hh          , Mm          , Mm          , Hh          , Hh          , Mm          , Hh          , Mm          , Hh          , Re          , Re          , Re          , Re          , Re          , Re          , Rd          , Re          , Re          , Re          , Re          , Re          , Ur          , Uu          , Yl          , Uu          , Ur          , Re          
Mm          , Mm^Xm       , Mm^Xm       , Mm          , Mm          , Mm          , Hh          , Gg          , Re          , Gg          , Ggf         , Ggf         , Ggf         , Hh          , Hh          , Gs^Fds      , Gs^Fds      , Gg          , Gg          , Hh          , Gg          , Hh          , Mm          , Hh          , Dd          , Hh          , Dd          , Hh          , Hh          , Re          , Re          , Rd          , Re          , Rd          , Rd          , Rd          , Re          , Re          , Re          , Re          , Rd          , Ur          , Ur          , Uu          , Ur          , Ur          , Re          
Mm          , Mm          , Mm          , Mm          , Hh          , Hh          , Re          , Re          , Ggf         , Re          , Re          , Re          , Re          , Gg          , Gg          , Gs^Fds      , Gg          , Gg          , Ggf         , Hh          , Gg          , Hh          , Hh          , Hh          , Dd          , Dd          , Dd          , Dd          , Hh          , Hh          , Re          , Rd          , Re          , Rd          , Re          , Rd          , Re          , Re          , Co          , Rd          , Rd          , Rd          , Re          , Ur          , Re          , Re          , Re          
Mm          , Mm          , Mm          , Hh          , Hh          , Gg          , Re          , Gg          , Re          , Re          , Gg          , Re          , Gg          , Gg          , Gg          , Gg          , Rd          , Ggf         , Gg          , Gg          , Gs^Fds      , Gg          , Gg          , Gg          , Gg          , Dd          , Dd          , Dd          , Re          , Re          , Rd          , Rd          , Re          , Re          , Re          , Re          , Re          , Co          , 2 Ko        , Co          , Rd          , Rd          , Re          , Re          , Re          , Re          , Rd          
Mm          , Mm          , Hh          , Hh          , Ggf         , Ggf         , Re          , Re          , Re          , Re          , Re          , Gs^Fds      , Gs^Fds      , Gg          , Gg          , Rd          , Gg          , Ggf         , Ggf         , Gg          , Gg          , Gs^Fds      , Gg          , Re          , Re          , Ggf         , Ggf         , Dd          , Dd          , Re          , Re          , Re          , Rd          , Re          , Re          , Re          , Re          , Co          , Co          , Co          , Rd          , Rd          , Re          , Re          , Rd          , Rd          , Re          
Hh          , Hh          , Gg          , Gg          , Re          , Re          , Re          , Re          , Re          , Gg          , Re          , Gg          , Gg          , Gg          , Rd          , Gg          , Ggf         , Ggf         , Gg          , Re          , Re          , Gg          , Gg          , Re          , Re          , Rd          , Gg          , Dd          , Dd          , Re          , Re          , Re          , Rd          , Rd          , Re          , Re          , Re          , Re          , Rd          , Rd          , Rd          , Rd          , Re          , Rd          , Re          , Re          , Re          
Ww          , Gg          , Re          , Re          , Ggf         , Re          , Gg          , Gg          , Re          , Re          , Re          , Re          , Gg          , Ggf         , Re          , Gg          , Gg          , Ggf         , Re          , Re          , Re          , Re          , Gg          , Re          , Re          , Rd          , Gg          , Dd          , Dd          , Dd          , Re          , Re          , Rd          , Re          , Rd          , Re          , Re          , Re          , Re          , Rd          , Re          , Re          , Re          , Rd          , Rd          , Re          , Re          
Dd          , Ww          , Ww          , Gg          , Rd          , Ggf         , Ggf         , Re          , Re          , Re          , Re          , Re          , Ggf         , Ggf         , Re          , Re          , Re          , Re          , Re          , Ggf         , Re          , Re          , Ggf         , Re          , Re          , Ggf         , Gg^Ve       , Dd          , Dd          , Dd          , Re          , Re          , Rd          , Re          , Re          , Rd          , Re          , Re          , Re          , Rd          , Rd          , Re          , Re          , Re          , Re          , Re          , Re          
Dd          , Dd          , Dd          , Ww          , Ww          , Rd          , Re          , Re          , Re          , Re          , Re          , Re          , Ggf         , Re          , Re          , Re          , Gg          , Re          , Ggf         , Re          , Re          , Gg          , Ggf         , Ggf         , Gg          , Re          , Gg          , Gg          , Gs^Fds      , Dd          , Dd          , Re          , Re          , Rd          , Re          , Rd          , Re          , Re          , Re          , Rd          , Re          , Rd          , Rd          , Re          , Re          , Re          , Re          
Dd          , Dd          , Dd          , Dd          , Ww          , Ww          , Re          , Re          , Re          , Re          , Gg          , Gg          , Gg          , Gg          , Gg          , Gg          , Gg          , Re          , Ggf         , Re          , Gg^Yc       , Gg^Yc       , Gg          , Ggf         , Re          , Gg          , Gg          , Gg          , Gs^Fds      , Dd          , Dd          , Re          , Re          , Re          , Re          , Rd          , Re          , Re          , Re          , Re          , Re          , Re          , Re          , Rd          , Re          , Re          , Rd          
Dd          , Dd          , Dd          , Dd          , Ww          , Ww          , Re          , Re          , Rd          , Rd          , Gg          , Gg          , Gg          , Gg^Ve       , Gg          , Gg          , Gs^Fds      , Ggf         , Ggf         , Gg          , Gg          , Gg          , Re          , Re          , Re          , Gg          , Hh          , Hh          , Hh          , Gg          , Gg          , Dd          , Dd          , Re          , Re          , Re          , Rd          , Re          , Re          , Re          , Re          , Re          , Re          , Re          , Re          , Re          , Rd          
Dd          , Dd          , Dd          , Dd          , Ww          , Ww          , Gg          , Gg          , Gg          , Gg          , Ggf         , Ggf         , Gg          , Gg          , Gg          , Gs^Fds      , Gs^Fds      , Gg          , Gg^Yc       , Gg^Yc       , Gg          , Gg          , Re          , Gg          , Re          , Gg          , Hh          , Mm          , Hh          , Hh          , Gg          , Dd          , Dd          , Re          , Re          , Rd          , Re          , Re          , Re          , Re^Vct      , Re          , Re          , Re          , Re          , Re          , Rd          , Re          
Dd          , Dd          , Dd          , Dd          , Ww          , Gs^Fds      , Gg          , Rd          , Gg          , Ggf         , Gg          , Re          , Re          , Re          , Gg          , Gs^Fds      , Gg          , Gg          , Gg^Yc       , Gg          , Ggf         , Gg          , Gg          , Re          , Gg          , Gg          , Hh          , Mm          , Hh          , Gg          , Ggf         , Dd          , Dd          , Dd          , Dd          , Rd          , Re          , Re          , Rd          , Rd          , Re          , Re          , Rd          , Re          , Re          , Re          , Re          
Dd          , Dd          , Dd          , Dd          , Ww          , Gs^Fds      , Rd          , Gg          , Re          , Re          , Re          , Gg          , Gg          , Gg          , Gg          , Gg          , Gg^Yc       , Gg^Yc       , Gg          , Gg          , Ggf         , Gg          , Rd          , Gg          , Rd          , Gg          , Ggf         , Hh          , Gg          , Gg          , Dd          , Dd          , Dd          , Dd          , Dd          , Re          , Re          , Re          , Re          , Re          , Re          , Re          , Re          , Rd          , Re          , Re          , Re          
Dd          , Dd          , Dd          , Ww          , Ww          , Gg          , Re          , Gg          , Re          , Gg          , Gg          , Gg          , Gg          , Gg          , Gg^Yc       , Gg^Yc       , Gg          , Ggf         , Re          , Gg          , Gg          , Ggf         , Gg          , Rd          , Gg          , Gg          , Ggf         , Gg          , Dd          , Dd          , Dd          , Dd          , Dd          , Dd          , Dd          , Dd          , Dd          , Re          , Rd          , Rd          , Re          , Re          , Re          , Rd          , Rd          , Re          , Re          
Dd          , Dd          , Ww          , Ww          , Re          , Re          , Gg          , Re          , Gg          , Gg          , Gg          , Gs^Fds      , Gg          , Gg^Yc       , Gg          , Gg          , Gg          , Re          , Re          , Re          , Gg          , Ggf         , Dd          , Gg          , Dd          , Dd          , Dd          , Dd          , Dd          , Dd          , Dd          , Dd          , Dd          , Dd          , Dd          , Rd          , Rd          , Dd          , Dd          , Re          , Dd          , Re          , Re          , Re          , Re          , Re          , Re          
Dd          , Dd          , Ww          , Gg          , Ggf         , Ggf         , Ggf         , Gg          , Re          , Re          , Gg          , Gg          , Gg          , Gg          , Ggf         , Ggf         , Re          , Re          , Gg          , Gg          , Dd          , Dd          , Dd          , Dd          , Dd          , Dd          , Dd          , Dd          , Dd          , Dd          , Dd          , Dd          , Dd          , Dd          , Dd          , Dd          , Rd          , Dd          , Dd          , Dd          , Dd          , Dd          , Dd          , Re          , Re          , Re          , Re          
Dd          , Dd          , Ww          , Ggf         , Ggf         , Ggf         , Gg          , Re          , Re          , Gg          , Re          , Re          , Re          , Gg          , Ggf         , Gg          , Gg          , Gg          , Dd          , Dd          , Dd          , Dd          , Dd          , Dd          , Dd          , Dd          , Cud         , Cud         , Cud         , Dd          , Dd          , Dd          , Dd          , Dd          , Dd          , Dd          , Dd          , Rd          , Dd          , Dd          , Dd          , Dd          , Dd          , Dd          , Re          , Re          , Re          
Dd          , Dd          , Ww          , Gg          , Rd          , Ggf         , Re          , Re          , Gg          , Re          , Ggf         , Re          , Gg          , Ggf         , Gg          , Gg          , Gs^Fds      , Gg          , Dd          , Dd          , Dd          , Dd          , Dd          , Dd          , Dd          , Dd          , Cud         , Ko          , Cud         , Dd          , Dd          , Dd          , Dd          , Dd          , Dd          , Dd          , Dd          , Rd          , Dd          , Dd          , Dd          , Dd          , Dd          , Dd          , Dd          , Dd          , Dd          
Dd          , Dd          , Ww          , Rd          , Gg          , Gg          , Re          , Re          , Gg          , Gg          , Gg          , Gg          , Gg          , Gg          , Gg          , Gs^Fds      , Gs^Fds      , Dd          , Dd          , Dd          , Rd          , Dd          , Dd          , Dd          , Dd          , Dd          , Dd          , Cud         , Dd          , Dd          , Dd          , Dd          , Dd          , Dd          , Dd          , Dd          , Dd          , Dd          , Rd          , Dd          , Dd          , Dd          , Rd          , Dd          , Dd          , Dd          , Dd          
Dd          , Dd          , Ww          , Gg          , Gg          , Gg          , Re          , Re          , Gg          , Gg^Ve       , Gg          , Ce          , Ce          , Ce          , Gg          , Gs^Fds      , Dd          , Dd          , Dd          , Dd          , Dd          , Rd          , Dd          , Dd          , Dd          , Dd          , Dd          , Dd          , Dd          , Dd          , Dd          , Dd          , Dd          , Dd          , Dd          , Dd          , Dd          , Rd          , Dd          , Dd          , Dd          , Dd          , Rd          , Dd          , Dd          , Dd          , Dd          
Ww          , Ww          , Rd          , Rd          , Gg          , Gg          , Re          , Re          , Re          , Gg          , Gg          , Ce          , 1 Ke        , Ce          , Gg          , Gg          , Dd          , Dd          , Dd          , Dd          , Dd          , Dd          , Dd          , Rd          , Dd          , Rd          , Dd          , Dd          , Dd          , Dd          , Dd          , Dd          , Dd          , Dd          , Dd          , Dd          , Dd          , Rd          , Dd          , Dd          , Dd          , Rd          , Dd          , Dd          , Dd          , Dd          , Dd          
Ww          , Gg          , Ggf         , Ggf         , Re          , Re          , Re          , Re          , Re          , Gg          , Gg          , Gg          , Ce          , Gg          , Ggf         , Dd          , Dd          , Dd          , Dd          , Dd          , Dd          , Dd          , Dd          , Rd          , Dd          , Dd          , Dd          , Dd          , Dd          , Dd          , Dd          , Dd          , Dd          , Dd          , Dd          , Dd          , Dd          , Rd          , Dd          , Dd          , Dd          , Rd          , Dd          , Dd          , Dd          , Dd          , Dd          
Gs^Fds      , Gg          , Gg          , Gg          , Gg          , Re          , Gg          , Re          , Re          , Re          , Re          , Gg          , Gg          , Gg          , Dd          , Dd          , Dd          , Dd          , Dd          , Dd          , Dd          , Dd          , Dd          , Dd          , Dd          , Dd          , Dd          , Dd          , Dd          , Dd          , Rd          , Dd          , Dd          , Dd          , Dd          , Dd          , Dd          , Dd^Vdt      , Dd          , Dd          , Dd          , Dd          , Dd          , Dd          , Dd          , Dd          , Dd          
Re          , Gs^Fds      , Gs^Fds      , Gg          , Ggf         , Gg          , Rd          , Gg          , Gg          , Re          , Gg          , Gg          , Dd          , Dd          , Dd          , Dd          , Dd          , Dd          , Dd          , Dd          , Dd          , Dd          , Dd          , Dd          , Dd          , Dd          , Dd          , Dd          , Dd          , Dd          , Rd          , Dd          , Dd          , Dd          , Dd          , Dd          , Dd          , Dd          , Dd          , Dd          , Dd          , Dd          , Dd          , Dd          , Dd          , Dd          , Dd          
Re          , Re          , Re          , Re          , Re          , Ggf         , Ggf         , Ggf         , Gg          , Gg          , Dd          , Dd          , Dd          , Dd          , Dd          , Dd          , Dd          , Dd          , Dd          , Dd          , Rd          , Dd          , Rd          , Rd          , Dd          , Dd          , Dd          , Dd          , Dd          , Dd          , Dd          , Rd          , Dd          , Dd          , Dd          , Dd          , Dd          , Dd          , Dd          , Dd          , Dd          , Dd          , Rd          , Rd          , Rd          , Dd          , Dd          
Re          , Re          , Re          , Re          , Gg          , Gg          , Dd          , Ggf         , Dd          , Dd          , Dd          , Dd          , Dd          , Dd          , Dd          , Dd          , Dd          , Dd          , Dd          , Dd          , Dd          , Dd          , Dd          , Dd          , Dd          , Dd          , Dd          , Dd          , Dd          , Dd          , Dd          , Rd          , Dd          , Dd          , Dd          , Dd          , Dd          , Dd          , Dd          , Dd          , Dd          , Dd          , Rd          , Dd          , Dd          , Dd          , Dd          
Re          , Re          , Ww          , Re          , Dd          , Dd          , Gg          , Dd          , Dd          , Dd          , Dd          , Dd          , Dd          , Dd          , Dd          , Dd          , Dd          , Dd          , Dd          , Dd          , Dd          , Dd          , Dd          , Dd          , Dd          , Dd          , Dd          , Dd          , Dd          , Dd          , Dd          , Dd          , Dd          , Dd          , Dd          , Dd          , Dd          , Dd          , Dd          , Dd          , Dd          , Dd          , Dd          , Dd          , Dd          , Dd          , Dd          
