border_size=1
usage=map

Xu          , Xu          , Xu          , Xu          , Xu          , Xu          , Xu          , Xu          , Xu          , Xu          , Xu          , Xu          , Xu          , Xu          , Xu          , Xu          , Xu          , Xu          , Xu          , Xu          , Xu          , Xu          , Xu          , Xu          , Xu          , Xu          , Xu          , Xu          , Xu          , Xu          
Xu          , Xu          , Xu          , Xu          , Xu          , Xu          , Xu          , Xu          , Xu          , Xu          , Xu          , Xu          , Xu          , Xu          , Xu          , Xu          , Xu          , Xu          , Xu          , Xu          , Xu          , Xu          , Xu          , Xu          , Xu          , Xu          , Xu          , Xu          , Xu          , Xu          
Xu          , Xu          , Xu          , Xu          , Xu          , Xu          , Xu          , Xu          , Xu          , Xu          , Xu          , Xu          , Xu          , Xu          , Uu          , Xu          , Uu          , Xu          , Uu          , Xu          , Xu          , Xu          , Xu          , Xu          , Xu          , Xu          , Xu          , Xu          , Xu          , Xu          
Xu          , Xu          , Xu          , Xu          , Xu          , Xu          , Xu          , Xu          , Xu          , Xu          , Xu          , Xu          , Uu          , Uu          , Yt          , Uu          , Xu          , Uu          , Uu^Vud      , Uu          , Uu          , Xu          , Xu          , Xu          , Xu          , Xu          , Xu          , Xu          , Xu          , Xu          
Xu          , Xu          , Xu          , Xu          , Xu          , Xu          , Xu          , Xu          , Xu          , Xu          , Xu          , Uu          , Uu          , Rd          , Re          , Uu          , Xu          , Uu          , Uu          , Uu          , Rd          , Uu          , Uu          , Xu          , Xu          , Xu          , Xu          , Xu          , Xu          , Xu          
Xu          , Xu          , Xu          , Xu          , Xu          , Xu          , Xu          , Xu          , Xu          , Xu          , Uu          , Uu          , Uu^Vud      , Uu          , Re          , Uu          , Xu          , Xu          , Xu          , Uu          , Re          , Rd          , Uu          , Uu          , Xu          , Xu          , Xu          , Xu          , Xu          , Xu          
Xu          , Xu          , Xu          , Xu          , Xu          , Xu          , Xu          , Xu          , Xu          , Xu          , Xu          , Uu          , Xu          , Uu          , Rd          , Rd          , Xu          , Xu          , Xu          , Uu          , Uu          , Uu          , Uu          , Xu          , Xu          , Xu          , Xu          , Xu          , Xu          , Xu          
Xu          , Xu          , Xu          , Xu          , Xu          , Xu          , Xu          , Xu          , Xu          , Xu          , Uu          , Uu          , Uu          , Xu          , Rd          , Uu          , Xu          , Xu          , Xu          , Xu          , Xu          , Uu          , Cud         , Cud         , Xu          , Xu          , Xu          , Xu          , Xu          , Xu          
Xu          , Xu          , Xu          , Xu          , Xu          , Xu          , Xu          , Xu          , Xu          , Xu          , Uu          , Uu          , Uu          , Xu          , Uu          , Xu          , Xu          , Xu          , Xu          , Xu          , Cud         , Cud         , Xu          , Xu          , Xu          , Xu          , Xu          , Xu          , Xu          , Xu          
Xu          , Xu          , Xu          , Xu          , Xu          , Xu          , Xu          , Xu          , Xu          , Uu          , Re          , Re          , Uu          , Uu          , Uu          , Uu          , Xu          , Xu          , Xu          , Xu          , Xu          , 2 Kud       , Xu          , Xu          , Xu          , Xu          , Xu          , Xu          , Xu          , Xu          
Xu          , Xu          , Xu          , Xu          , Xu          , Xu          , Xu          , Xu          , Xu          , Uu          , Yt          , Yt          , Uu          , Uu          , Uu          , Uu          , Xu          , Xu          , Xu          , Xu          , Xu          , Xu          , Xu          , Xu          , Qxu         , Qxu         , Xu          , Xu          , Xu          , Xu          
Xu          , Xu          , Xu          , Xu          , Yl          , Xu          , Xu          , Xu          , Uu          , Uu          , Yt          , Uu          , Xu          , Xu          , Xu          , Xu          , Yl          , Xu          , Yl          , Xu          , Xu          , Xu          , Xu          , Qxu         , Qxu         , Qxu         , Yl          , Xu          , Xu          , Xu          
Xu          , Xu          , Xu          , Xu          , Yl          , Xu          , Xu          , Xu          , Uu          , Uu          , Uu          , Uu          , Xu          , Yl          , Yl          , Yl          , Yl          , Yl          , Yl          , Xu          , Yl          , Xu          , Xu          , Xu          , Yl          , Yl          , Yl          , Yl          , Yl          , Yl          
Xu          , Xu          , Xu          , Yl          , Yl          , Yl          , Yl          , Yl          , Yl          , Yl          , Yl          , Yl          , Yl          , Yl          , Yl          , Yl          , Yl          , Yl          , Yl          , Yl          , Yl          , Yl          , Yl          , Yl          , Yl          , Yl          , Yl          , Yl          , Yl          , Yl          
Yl          , Yl          , Yl          , Yl          , Yl          , Yl          , Yl          , Yl          , Yl          , Yl          , Yl          , Yl          , Yl          , Yl          , Xu          , Xu          , Yl          , Yl          , Yl          , Yl          , Yl          , Yl          , Cud         , Yl          , Yl          , Yl          , Yl          , Yl          , Yl          , Yl          
Yl          , Yl          , Yl          , Yl          , Yl          , Yl          , Yl          , Yl          , Yl          , Yl          , Yl          , Yl          , Yl          , Yl          , Xu          , Yl          , Yl          , Yl          , Yl          , Yl          , Yl          , Cud         , 1 Kud       , Cud         , Yl          , Yl          , Yl          , Yl          , Yl          , Yl          
Yl          , Yl          , Yl          , Yl          , Yl          , Yl          , Yl          , Yl          , Yl          , Yl          , Yl          , Yl          , Yl          , Yl          , Yl          , Yl          , Xu          , Yl          , Yl          , Yl          , Yl          , Cud         , Cud         , Cud         , Yl          , Yl          , Yl          , Yl          , Yl          , Yl          
Yl          , Yl          , Yl          , Yl          , Yl          , Yl          , Yl          , Yl          , Yl          , Yl          , Yl          , Yl          , Yl          , Yl          , Yl          , Yl          , Yl          , Xu          , Xu          , Yl          , Yl          , Yl          , Yl          , Yl          , Yl          , Yl          , Yl          , Yl          , Yl          , Yl          
Yl          , Yl          , Xu          , Yl          , Xu          , Yl          , Yl          , Yl          , Yl          , Yl          , Yl          , Yl          , Yl          , Yl          , Yl          , Yl          , Yl          , Xu          , Xu          , Yl          , Yl          , Yl          , Yl          , Yl          , Yl          , Yl          , Yl          , Yl          , Yl          , Yl          
Xu          , Xu          , Xu          , Xu          , Xu          , Xu          , Xu          , Yl          , Yl          , Yl          , Yt          , Yt          , Yt          , Yl          , Yl          , Yl          , Xu          , Xu          , Xu          , Xu          , Xu          , Yl          , Yl          , Yl          , Yl          , Yl          , Yl          , Yl          , Yl          , Yl          
Xu          , Xu          , Xu          , Xu          , Xu          , Xu          , Xu          , Yl          , Xu          , Uu          , Yt          , Xu          , Yt          , Uu          , Uu          , Xu          , Xu          , Xu          , Xu          , Xu          , Xu          , Xu          , Uu          , Uu          , Uu          , Xu          , Yl          , Yl          , Yl          , Yl          
Xu          , Xu          , Xu          , Xu          , Xu          , Xu          , Xu          , Xu          , Uu          , Uu          , Uu          , Yt          , Uu          , Uu          , Xu          , Xu          , Xu          , Xu          , Xu          , Xu          , Xu          , Xu          , Xu          , Uu^Vud      , Uu          , Xu          , Xu          , Yl          , Xu          , Xu          
Xu          , Xu          , Xu          , Xu          , Xu          , Xu          , Xu          , Xu          , Uu          , Uu          , Uu          , Uu          , Uu          , Xu          , Xu          , Uu          , Uu          , Xu          , Xu          , Xu          , Uu          , Xu          , Uu          , Uu          , Uu          , Uu          , Xu          , Xu          , Xu          , Xu          
Xu          , Xu          , Xu          , Xu          , Xu          , Xu          , Xu          , Xu          , Xu          , Uu          , Qxu         , Qxu         , Uu          , Uu          , Uu          , Uu          , Uu          , Uu          , Rd          , Uu          , Re          , Re          , Xu          , Uu          , Uu          , Uu          , Xu          , Xu          , Xu          , Xu          
Xu          , Xu          , Xu          , Xu          , Xu          , Xu          , Xu          , Xu          , Xu          , Uu          , Re          , Rd          , Uu          , Uu          , Uu          , Uu          , Uu          , Rd          , Xu          , Uu          , Xu          , Re          , Xu          , Uu          , Rd          , Xu          , Xu          , Xu          , Xu          , Xu          
Xu          , Xu          , Xu          , Xu          , Xu          , Xu          , Xu          , Xu          , Xu          , Uu          , Rd          , Rd          , Uu          , Uu          , Xu          , Uu          , Xu          , Uu          , Xu          , Xu          , Uu^Vu       , Xu          , Xu          , Rd          , Re          , Uu          , Xu          , Xu          , Xu          , Xu          
Xu          , Xu          , Xu          , Xu          , Xu          , Xu          , Xu          , Xu          , Xu          , Re          , Uu          , Uu          , Uu          , Xu          , Xu          , Xu          , Xu          , Xu          , Uu^Vu       , Uu^Vu       , Uu^Vu       , Xu          , Uu          , Rd          , Uu          , Xu          , Xu          , Xu          , Xu          , Xu          
Xu          , Xu          , Xu          , Xu          , Xu          , Xu          , Xu          , Xu          , Xu          , Uu          , Uu          , Uu          , Uu          , Uu^Vud      , Xu          , Xu          , Xu          , Xu          , Xu          , Uu^Vu       , Xu          , Xu          , Xu          , Uu          , Uu          , Xu          , Xu          , Xu          , Xu          , Xu          
Xu          , Xu          , Xu          , Xu          , Xu          , Xu          , Xu          , Xu          , Xu          , Uu          , Uu^Ii       , Uu          , Uu          , Xu          , Xu          , Xu          , Xu          , Xu          , Xu          , Xu          , Xu          , Xu          , Xu          , Uu          , Uu          , Xu          , Cud         , Xu          , Xu          , Xu          
Xu          , Xu          , Xu          , Xu          , Xu          , Xu          , Xu          , Xu          , Xu          , Uu^Ii       , Gg          , Uu^Ii       , Xu          , Xu          , Xu          , Xu          , Xu          , Xu          , Xu          , Xu          , Xu          , Xu          , Xu          , Uu          , Uu          , Cud         , 3 Kud       , Xu          , Xu          , Xu          
Xu          , Xu          , Xu          , Xu          , Xu          , Xu          , Xu          , Xu          , Gg          , Gg          , Gg          , Gg          , Gg          , Xu          , Xu          , Xu          , Xu          , Xu          , Xu          , Xu          , Xu          , Xu          , Xu          , Xu          , Xu          , Cud         , Xu          , Xu          , Xu          , Xu          
Xu          , Xu          , Xu          , Xu          , Xu          , Xu          , Xu          , Xu          , Gg          , Gg          , Gg          , Gg          , Gg          , Xu          , Xu          , Xu          , Xu          , Xu          , Xu          , Xu          , Xu          , Xu          , Xu          , Xu          , Xu          , Cud         , Xu          , Xu          , Xu          , Xu          
